22 22 22 22 22 22 22 22 22 22 22 22 22 22 22 22 22 22 22 22 22 22 22 22 22 22 22 22 22 22 22 22 22 22 22 22 3 3 3 3 3 3 3 3 3 3 3 3 3 3 
22 22 22 22 22 22 22 22 22 22 22 22 22 22 22 22 22 22 22 22 22 22 22 22 22 22 22 22 22 22 22 22 22 22 22 22 3 3 3 3 3 3 3 3 3 3 3 3 3 3 
22 22 3 3 3 3 3 3 3 3 3 3 3 3 3 3 3 3 3 3 3 3 3 3 3 3 3 3 3 3 3 3 3 3 22 22 3 3 3 3 3 3 3 3 3 3 3 3 3 3 
22 22 3 3 3 3 3 3 3 3 3 3 3 3 3 3 3 3 3 3 3 3 3 3 3 3 3 3 3 3 3 3 3 3 22 22 3 3 3 3 3 3 3 3 3 3 3 3 3 3 
22 22 3 3 3 3 3 3 3 3 3 3 3 3 3 3 3 3 3 3 3 3 3 3 3 3 3 3 3 3 3 3 3 3 22 22 3 3 3 3 3 3 3 3 3 3 3 3 3 3 
22 22 3 3 3 3 3 3 3 3 3 3 3 3 3 3 3 3 3 3 3 3 3 3 3 3 3 3 3 3 3 3 3 3 22 22 3 3 3 3 3 3 3 3 3 3 3 3 3 3 
22 22 3 3 3 3 3 3 3 3 3 3 3 3 3 3 3 3 3 3 3 3 3 3 3 3 3 3 3 3 3 3 3 3 22 22 3 3 3 3 3 3 3 3 3 3 3 3 3 3 
22 22 3 3 3 3 3 3 3 3 3 3 3 3 3 3 3 3 3 3 3 3 3 3 3 3 3 3 3 3 3 3 3 3 22 22 3 3 3 3 3 3 3 3 3 3 3 3 3 3 
22 22 3 3 3 3 3 3 3 3 3 3 3 3 3 3 3 3 3 3 21 3 3 3 3 3 3 3 3 3 3 3 3 3 22 22 3 3 3 3 3 3 3 3 3 3 3 3 3 3 
22 22 3 3 3 3 3 3 3 3 3 3 3 3 3 3 22 22 22 22 3 3 3 3 3 3 3 3 3 3 3 3 3 3 22 22 3 3 3 3 3 3 3 3 3 3 3 3 3 3 
22 22 3 3 3 3 3 3 3 3 3 3 3 3 3 3 3 3 21 22 3 3 3 3 3 3 3 3 3 3 3 3 3 3 22 22 3 3 3 3 3 3 3 3 3 3 3 3 3 3 
22 22 3 3 3 3 3 3 3 3 3 5 3 3 3 3 3 3 3 22 22 3 3 3 3 3 3 3 3 3 3 3 3 3 22 22 3 3 3 3 3 3 3 3 3 3 3 3 3 3 
22 22 3 3 3 3 3 3 3 3 3 3 3 3 25 27 3 3 3 22 22 3 3 3 3 3 3 3 3 3 3 3 3 3 22 22 3 3 3 3 3 3 3 3 3 3 3 3 3 3 
22 22 3 3 3 3 3 3 3 3 3 3 3 3 30 32 4 3 3 22 22 3 3 3 3 3 3 3 3 3 3 3 3 3 22 22 3 3 3 3 3 3 3 3 3 3 3 3 3 3 
22 22 3 3 3 3 3 3 3 3 3 3 21 3 3 3 3 3 3 22 22 3 3 3 3 3 3 3 3 3 3 3 3 3 22 22 3 3 3 3 3 3 3 3 3 3 3 3 3 3 
22 22 3 3 3 3 3 3 3 3 3 3 3 3 3 3 3 3 3 22 22 3 3 3 3 3 3 3 3 3 3 3 3 3 22 22 3 3 3 3 3 3 3 3 3 3 3 3 3 3 
22 22 3 3 3 3 3 3 3 3 3 3 3 3 21 3 3 22 22 22 22 3 3 3 3 3 3 3 3 3 3 3 3 3 22 22 3 3 3 3 3 3 3 3 3 3 3 3 3 3 
22 22 3 3 3 3 3 3 3 3 3 3 3 3 3 3 3 3 3 3 3 3 3 3 3 3 3 3 3 3 3 3 3 3 22 22 3 3 3 3 3 3 3 3 3 3 3 3 3 3 
22 22 3 3 3 3 3 3 3 3 3 3 3 3 3 3 3 3 3 3 3 3 3 3 3 3 3 3 3 3 3 3 3 3 22 22 3 3 3 3 3 3 3 3 3 3 3 3 3 3 
22 22 3 3 3 3 3 3 3 3 3 3 3 3 3 3 3 3 3 3 3 3 3 3 3 3 3 3 3 3 3 3 3 3 22 22 3 3 3 3 3 3 3 3 3 3 3 3 3 3 
22 22 3 3 3 3 3 3 3 3 3 3 3 3 3 3 3 3 3 3 3 3 3 3 3 3 3 3 3 3 3 3 3 3 22 22 3 3 3 3 3 3 3 3 3 3 3 3 3 3 
22 22 3 3 3 3 3 3 3 3 3 3 3 3 3 3 3 3 3 3 3 3 3 3 3 3 3 3 3 3 3 3 3 3 22 22 3 3 3 3 3 3 3 3 3 3 3 3 3 3 
22 22 3 3 3 3 3 3 3 3 3 3 3 3 3 3 3 3 3 3 3 3 3 3 3 3 3 3 3 3 3 3 3 3 22 22 3 3 3 3 3 3 3 3 3 3 3 3 3 3 
22 22 3 3 3 3 3 3 3 3 3 3 3 3 3 3 3 3 3 3 3 3 3 3 3 3 3 3 3 3 3 3 3 3 22 22 3 3 3 3 3 3 3 3 3 3 3 3 3 3 
22 22 3 3 3 3 3 3 3 3 3 3 3 3 3 3 3 3 3 3 3 3 3 3 3 3 3 3 3 3 3 3 3 3 22 22 3 3 3 3 3 3 3 3 3 3 3 3 3 3 
22 22 3 3 3 3 3 3 3 3 3 3 3 3 3 3 3 3 3 3 3 3 3 3 3 3 3 3 3 3 3 3 3 3 22 22 3 3 3 3 3 3 3 3 3 3 3 3 3 3 
22 22 3 3 3 3 3 3 3 3 3 3 3 3 3 3 3 3 3 3 3 3 3 3 3 3 3 3 3 3 3 3 3 3 22 22 3 3 3 3 3 3 3 3 3 3 3 3 3 3 
22 22 22 22 22 22 22 22 22 22 22 22 22 22 22 22 22 22 22 22 22 22 22 22 22 22 22 22 22 22 22 22 22 22 22 22 3 3 3 3 3 3 3 3 3 3 3 3 3 3 
22 22 22 22 22 22 22 22 22 22 22 22 22 22 22 22 22 22 22 22 22 22 22 22 22 22 22 22 22 22 22 22 22 22 22 22 3 3 3 3 3 3 3 3 3 3 3 3 3 3 
3 3 3 3 3 3 3 3 3 3 3 3 3 3 3 3 3 3 3 3 3 3 3 3 3 3 3 3 3 3 3 3 3 3 3 3 3 3 3 3 3 3 3 3 3 3 3 3 3 3 
3 3 3 3 3 3 3 3 3 3 3 3 3 3 3 3 3 3 3 3 3 3 3 3 3 3 3 3 3 3 3 3 3 3 3 3 3 3 3 3 3 3 3 3 3 3 3 3 3 3 
3 3 3 3 3 3 3 3 3 3 3 3 3 3 3 3 3 3 3 3 3 3 3 3 3 3 3 3 3 3 3 3 3 3 3 3 3 3 3 3 3 3 3 3 3 3 3 3 3 3 
3 3 3 3 3 3 3 3 3 3 3 3 3 3 3 3 3 3 3 3 3 3 3 3 3 3 3 3 3 3 3 3 3 3 3 3 3 3 3 3 3 3 3 3 3 3 3 3 3 3 
3 3 3 3 3 3 3 3 3 3 3 3 3 3 3 3 3 3 3 3 3 3 3 3 3 3 3 3 3 3 3 3 3 3 3 3 3 3 3 3 3 3 3 3 3 3 3 3 3 3 
3 3 3 3 3 3 3 3 3 3 3 3 3 3 3 3 3 3 3 3 3 3 3 3 3 3 3 3 3 3 3 3 3 3 3 3 3 3 3 3 3 3 3 3 3 3 3 3 3 3 
3 3 3 3 3 3 3 3 3 3 3 3 3 3 3 3 3 3 3 3 3 3 3 3 3 3 3 3 3 3 3 3 3 3 3 3 3 3 3 3 3 3 3 3 3 3 3 3 3 3 
3 3 3 3 3 3 3 3 3 3 3 3 3 3 3 3 3 3 3 3 3 3 3 3 3 3 3 3 3 3 3 3 3 3 3 3 3 3 3 3 3 3 3 3 3 3 3 3 3 3 
3 3 3 3 3 3 3 3 3 3 3 3 3 3 3 3 3 3 3 3 3 3 3 3 3 3 3 3 3 3 3 3 3 3 3 3 3 3 3 3 3 3 3 3 3 3 3 3 3 3 
3 3 3 3 3 3 3 3 3 3 3 3 3 3 3 3 3 3 3 3 3 3 3 3 3 3 3 3 3 3 3 3 3 3 3 3 3 3 3 3 3 3 3 3 3 3 3 3 3 3 
3 3 3 3 3 3 3 3 3 3 3 3 3 3 3 3 3 3 3 3 3 3 3 3 3 3 3 3 3 3 3 3 3 3 3 3 3 3 3 3 3 3 3 3 3 3 3 3 3 3 
3 3 3 3 3 3 3 3 3 3 3 3 3 3 3 3 3 3 3 3 3 3 3 3 3 3 3 3 3 3 3 3 3 3 3 3 3 3 3 3 3 3 3 3 3 3 3 3 3 3 
3 3 3 3 3 3 3 3 3 3 3 3 3 3 3 3 3 3 3 3 3 3 3 3 3 3 3 3 3 3 3 3 3 3 3 3 3 3 3 3 3 3 3 3 3 3 3 3 3 3 
3 3 3 3 3 3 3 3 3 3 3 3 3 3 3 3 3 3 3 3 3 3 3 3 3 3 3 3 3 3 3 3 3 3 3 3 3 3 3 3 3 3 3 3 3 3 3 3 3 3 
3 3 3 3 3 3 3 3 3 3 3 3 3 3 3 3 3 3 3 3 3 3 3 3 3 3 3 3 3 3 3 3 3 3 3 3 3 3 3 3 3 3 3 3 3 3 3 3 3 3 
3 3 3 3 3 3 3 3 3 3 3 3 3 3 3 3 3 3 3 3 3 3 3 3 3 3 3 3 3 3 3 3 3 3 3 3 3 3 3 3 3 3 3 3 3 3 3 3 3 3 
3 3 3 3 3 3 3 3 3 3 3 3 3 3 3 3 3 3 3 3 3 3 3 3 3 3 3 3 3 3 3 3 3 3 3 3 3 3 3 3 3 3 3 3 3 3 3 3 3 3 
3 3 3 3 3 3 3 3 3 3 3 3 3 3 3 3 3 3 3 3 3 3 3 3 3 3 3 3 3 3 3 3 3 3 3 3 3 3 3 3 3 3 3 3 3 3 3 3 3 3 
3 3 3 3 3 3 3 3 3 3 3 3 3 3 3 3 3 3 3 3 3 3 3 3 3 3 3 3 3 3 3 3 3 3 3 3 3 3 3 3 3 3 3 3 3 3 3 3 3 3 
3 3 3 3 3 3 3 3 3 3 3 3 3 3 3 3 3 3 3 3 3 3 3 3 3 3 3 3 3 3 3 3 3 3 3 3 3 3 3 3 3 3 3 3 3 3 3 3 3 3 
3 3 3 3 3 3 3 3 3 3 3 3 3 3 3 3 3 3 3 3 3 3 3 3 3 3 3 3 3 3 3 3 3 3 3 3 3 3 3 3 3 3 3 3 3 3 3 3 3 3 
