22 22 22 22 22 22 22 22 22 22 22 22 22 22 22 22 22 22 22 22 22 22 22 22 22 22 22 22 22 22 22 22 22 22 22 22 22 22 22 22 22 22 22 22 22 22 22 22 22 22 
22 22 22 22 22 22 22 22 22 22 22 22 22 22 22 22 22 22 22 22 22 22 22 22 22 22 22 22 22 22 22 22 22 22 22 22 22 22 22 22 22 22 22 22 22 22 22 22 22 22 
22 22 22 22 22 22 22 22 22 22 22 22 22 22 22 22 22 22 22 22 22 22 22 22 22 22 22 22 22 22 22 22 22 22 22 22 22 22 22 22 22 22 22 22 22 22 22 22 22 22 
22 22 22 6 6 6 6 6 6 6 6 6 6 6 6 6 6 6 6 6 6 6 6 6 6 6 6 6 6 6 6 6 6 6 22 22 22 22 22 22 22 22 22 22 22 22 22 22 22 22 
22 22 22 6 6 6 6 6 6 6 6 6 6 6 6 6 6 6 6 6 6 6 6 6 6 6 6 6 6 6 6 6 6 6 22 22 22 22 22 22 22 22 22 22 22 22 22 22 22 22 
22 22 22 6 6 6 6 6 26 26 26 26 26 26 26 26 6 6 6 6 6 6 6 6 6 6 8 8 6 6 6 6 6 6 22 22 22 22 22 22 22 22 22 22 22 22 22 22 22 22 
22 22 22 6 6 6 6 6 26 1 1 1 1 1 1 26 6 6 6 6 6 6 6 6 6 6 6 6 6 6 6 6 6 6 22 22 22 22 22 22 22 22 22 22 22 22 22 22 22 22 
22 22 22 6 6 6 6 6 26 1 1 1 1 1 1 6 6 6 6 6 6 6 6 6 6 6 6 6 6 6 6 6 6 6 22 22 22 22 22 22 22 22 22 22 22 22 22 22 22 22 
22 22 22 6 6 6 6 6 26 1 1 1 1 1 1 26 6 6 6 6 6 6 6 6 6 6 6 6 6 6 6 6 6 6 22 22 22 22 22 22 22 22 22 22 22 22 22 22 22 22 
22 22 22 6 6 6 6 6 26 26 26 26 26 26 26 26 6 6 6 6 6 6 29 30 31 6 6 6 6 6 6 6 6 6 22 22 22 22 22 22 22 22 22 22 22 22 22 22 22 22 
22 22 22 6 6 6 6 6 6 6 6 6 6 6 6 6 6 6 6 6 6 6 32 27 39 30 30 30 30 30 31 6 6 6 22 22 22 22 22 22 22 22 22 22 22 22 22 22 22 22 
22 22 22 6 6 6 6 6 6 6 6 6 6 6 6 6 6 6 6 6 6 6 32 28 27 27 27 27 27 28 33 6 6 6 22 22 22 22 22 22 22 22 22 22 22 22 22 22 22 22 
22 22 22 6 6 6 6 6 6 6 6 6 6 6 6 6 6 6 6 6 6 6 32 27 27 27 28 27 27 27 33 6 6 6 22 22 22 22 22 22 22 22 22 22 22 22 22 22 22 22 
22 22 22 6 6 6 6 6 6 6 6 6 6 6 6 6 6 6 6 6 6 6 32 27 28 27 27 27 27 37 36 6 6 6 22 22 22 22 22 22 22 22 22 22 22 22 22 22 22 22 
22 22 22 6 6 6 6 6 6 6 6 6 6 6 6 6 6 6 6 6 6 6 34 35 35 35 35 35 35 36 6 6 6 6 22 22 22 22 22 22 22 22 22 22 22 22 22 22 22 22 
22 22 22 6 6 6 6 6 6 6 6 6 6 6 6 6 6 6 6 6 6 6 6 6 6 6 6 6 6 6 6 6 6 6 22 22 22 22 22 22 22 22 22 22 22 22 22 22 22 22 
22 22 22 6 6 6 6 6 6 6 6 6 6 6 6 6 6 6 6 6 6 6 6 6 6 6 6 6 6 6 6 6 6 6 22 22 22 22 22 22 22 22 22 22 22 22 22 22 22 22 
22 22 22 6 6 6 6 6 6 6 6 6 6 6 6 6 6 6 6 6 6 6 6 6 6 6 6 6 6 6 6 6 6 6 22 22 22 22 22 22 22 22 22 22 22 22 22 22 22 22 
22 22 22 6 6 6 6 6 6 6 6 6 6 6 6 6 6 6 6 6 6 6 6 6 6 6 6 6 6 6 6 6 6 6 22 22 22 22 22 22 22 22 22 22 22 22 22 22 22 22 
22 22 22 6 6 6 6 6 6 6 6 6 6 6 6 6 6 6 6 6 6 6 6 6 6 6 6 6 6 6 6 6 6 6 22 22 22 22 22 22 22 22 22 22 22 22 22 22 22 22 
22 22 22 6 6 6 6 6 6 6 6 6 6 6 6 6 6 6 6 6 6 6 6 6 6 6 6 6 6 6 6 6 6 6 22 22 22 22 22 22 22 22 22 22 22 22 22 22 22 22 
22 22 22 6 6 6 6 6 6 6 6 6 6 6 6 6 6 6 6 6 6 6 6 6 6 6 6 6 6 6 6 6 6 6 22 22 22 22 22 22 22 22 22 22 22 22 22 22 22 22 
22 22 22 6 6 6 6 6 6 6 6 6 6 6 6 6 6 6 6 6 6 6 6 6 6 6 6 6 6 6 6 6 6 6 22 22 22 22 22 22 22 22 22 22 22 22 22 22 22 22 
22 22 22 6 6 6 6 6 6 6 6 6 6 6 6 6 6 6 6 6 6 6 6 6 6 6 6 6 6 6 6 6 6 6 22 22 22 22 22 22 22 22 22 22 22 22 22 22 22 22 
22 22 22 6 6 6 6 6 6 6 6 6 6 6 6 6 6 6 6 6 6 6 6 6 6 6 6 6 6 6 6 6 6 6 22 22 22 22 22 22 22 22 22 22 22 22 22 22 22 22 
22 22 22 6 6 6 6 6 6 6 6 6 6 6 6 6 6 6 6 6 6 6 6 6 6 6 6 6 6 6 6 6 6 6 22 22 22 22 22 22 22 22 22 22 22 22 22 22 22 22 
22 22 22 6 6 6 6 6 6 6 6 6 6 6 6 6 6 6 6 6 6 6 6 6 6 6 6 6 6 6 6 6 6 6 22 22 22 22 22 22 22 22 22 22 22 22 22 22 22 22 
22 22 22 6 6 6 6 6 6 6 6 6 6 6 6 6 6 6 6 6 6 6 6 6 6 6 6 6 6 6 6 6 6 6 22 22 22 22 22 22 22 22 22 22 22 22 22 22 22 22 
22 22 22 6 6 6 6 6 6 6 6 6 6 6 6 6 6 6 6 6 6 6 6 6 6 6 6 6 6 6 6 6 6 6 22 22 22 22 22 22 22 22 22 22 22 22 22 22 22 22 
22 22 22 6 6 6 6 6 6 6 6 6 6 6 6 6 6 6 6 6 6 6 6 6 6 6 6 6 6 6 6 6 6 6 22 22 22 22 22 22 22 22 22 22 22 22 22 22 22 22 
22 22 22 6 6 6 6 6 6 6 6 6 6 6 6 6 6 6 6 6 6 6 6 6 6 6 6 6 6 6 6 6 6 6 22 22 22 22 22 22 22 22 22 22 22 22 22 22 22 22 
22 22 22 6 6 6 6 6 6 6 6 6 6 6 6 6 6 6 6 6 6 6 6 6 6 6 6 6 6 6 6 6 6 6 22 22 22 22 22 22 22 22 22 22 22 22 22 22 22 22 
22 22 22 6 6 6 6 6 6 6 6 6 6 6 6 6 6 6 6 6 6 6 6 6 6 6 6 6 6 6 6 6 6 6 22 22 22 22 22 22 22 22 22 22 22 22 22 22 22 22 
22 22 22 6 6 6 6 6 6 6 6 6 6 6 6 6 6 6 6 6 6 6 6 6 6 6 6 6 6 6 6 6 6 6 22 22 22 22 22 22 22 22 22 22 22 22 22 22 22 22 
22 22 22 6 6 6 6 6 6 6 6 6 6 6 6 6 6 6 6 6 6 6 6 6 6 6 6 6 6 6 6 6 6 6 22 22 22 22 22 22 22 22 22 22 22 22 22 22 22 22 
22 22 22 6 6 6 6 6 6 6 6 6 6 6 6 6 6 6 6 6 6 6 6 6 6 6 6 6 6 6 6 6 6 6 22 22 22 22 22 22 22 22 22 22 22 22 22 22 22 22 
22 22 22 6 6 6 6 6 6 6 6 6 6 6 6 6 6 6 6 6 6 6 6 6 6 6 6 6 6 6 6 6 6 6 22 22 22 22 22 22 22 22 22 22 22 22 22 22 22 22 
22 22 22 6 6 6 6 6 6 6 6 6 6 6 6 6 6 6 6 6 6 6 6 6 6 6 6 6 6 6 6 6 6 6 22 22 22 22 22 22 22 22 22 22 22 22 22 22 22 22 
22 22 22 6 6 6 6 6 6 6 6 6 6 6 6 6 6 6 6 6 6 6 6 6 6 6 6 6 6 6 6 6 6 6 22 22 22 22 22 22 22 22 22 22 22 22 22 22 22 22 
22 22 22 6 6 6 6 6 6 6 6 6 6 6 6 6 6 6 6 6 6 6 6 6 6 6 6 6 6 6 6 6 6 6 22 22 22 22 22 22 22 22 22 22 22 22 22 22 22 22 
22 22 22 6 6 6 6 6 6 6 6 6 6 6 6 6 6 6 6 6 6 6 6 6 6 6 6 6 6 6 6 6 6 6 22 22 22 22 22 22 22 22 22 22 22 22 22 22 22 22 
22 22 22 22 22 22 22 22 22 22 22 22 22 22 22 22 22 22 22 22 22 22 22 22 22 22 22 22 22 22 22 22 22 22 22 22 22 22 22 22 22 22 22 22 22 22 22 22 22 22 
22 22 22 22 22 22 22 22 22 22 22 22 22 22 22 22 22 22 22 22 22 22 22 22 22 22 22 22 22 22 22 22 22 22 22 22 22 22 22 22 22 22 22 22 22 22 22 22 22 22 
22 22 22 22 22 22 22 22 22 22 22 22 22 22 22 22 22 22 22 22 22 22 22 22 22 22 22 22 22 22 22 22 22 22 22 22 22 22 22 22 22 22 22 22 22 22 22 22 22 22 
22 22 22 22 22 22 22 22 22 22 22 22 22 22 22 22 22 22 22 22 22 22 22 22 22 22 22 22 22 22 22 22 22 22 22 22 22 22 22 22 22 22 22 22 22 22 22 22 22 22 
22 22 22 22 22 22 22 22 22 22 22 22 22 22 22 22 22 22 22 22 22 22 22 22 22 22 22 22 22 22 22 22 22 22 22 22 22 22 22 22 22 22 22 22 22 22 22 22 22 22 
22 22 22 22 22 22 22 22 22 22 22 22 22 22 22 22 22 22 22 22 22 22 22 22 22 22 22 22 22 22 22 22 22 22 22 22 22 22 22 22 22 22 22 22 22 22 22 22 22 22 
22 22 22 22 22 22 22 22 22 22 22 22 22 22 22 22 22 22 22 22 22 22 22 22 22 22 22 22 22 22 22 22 22 22 22 22 22 22 22 22 22 22 22 22 22 22 22 22 22 22 
22 22 22 22 22 22 22 22 22 22 22 22 22 22 22 22 22 22 22 22 22 22 22 22 22 22 22 22 22 22 22 22 22 22 22 22 22 22 22 22 22 22 22 22 22 22 22 22 22 22 
22 22 22 22 22 22 22 22 22 22 22 22 22 22 22 22 22 22 22 22 22 22 22 22 22 22 22 22 22 22 22 22 22 22 22 22 22 22 22 22 22 22 22 22 22 22 22 22 22 22 
