1 1 1 1 1 1 1 1 1 1 1 1 1 1 1 1 1 1 1 1 1 1 1 1 1 1 1 1 1 1 1
1 0 0 0 0 0 0 0 1 0 0 0 0 0 0 0 0 0 0 0 0 0 0 0 0 0 0 0 0 1 1
1 0 0 0 1 1 1 0 1 0 0 1 1 1 1 1 0 0 0 0 0 0 0 1 1 1 0 0 0 1 1
1 0 0 0 0 0 0 0 1 0 0 0 1 0 0 0 0 0 0 0 0 0 0 0 0 0 0 0 0 1 1
1 0 0 0 2 2 2 0 1 0 0 0 1 0 0 0 2 2 2 2 2 0 0 0 0 0 0 0 0 1 1
1 0 2 2 2 2 0 0 0 1 1 1 1 0 0 0 2 0 0 0 2 0 0 0 0 0 0 0 0 1 1
1 0 2 2 0 0 0 0 0 0 0 0 0 0 0 0 2 0 0 0 2 0 0 0 0 0 0 0 0 1 1
1 0 0 0 0 0 0 0 0 0 0 0 2 0 0 0 2 2 2 2 2 0 0 0 0 0 0 0 0 1 1
1 0 0 0 0 0 0 0 0 0 0 0 0 0 0 0 0 0 0 0 0 0 0 0 0 0 0 0 0 1 1
1 0 0 0 0 0 0 0 0 1 3 1 0 0 0 0 0 0 0 0 0 0 0 0 0 0 0 0 0 1 1
1 0 0 0 0 0 0 0 0 1 3 1 0 2 0 0 2 0 0 2 0 0 0 0 0 0 0 0 0 1 1
1 0 0 0 0 0 0 0 0 1 3 1 0 0 0 0 0 0 0 0 0 0 0 0 0 0 0 0 0 1 1
1 0 0 0 2 2 2 0 0 1 3 1 0 0 0 0 2 2 2 2 0 0 0 0 0 0 0 0 0 1 1
1 0 0 0 2 0 0 0 0 1 3 1 1 1 1 0 0 0 0 0 2 0 0 0 0 0 0 0 0 1 1
1 0 0 0 2 0 0 0 0 1 3 3 3 3 3 3 0 0 0 0 2 0 0 0 0 0 0 0 0 1 1
1 0 0 0 2 2 2 2 0 1 1 1 1 1 1 1 0 0 0 0 2 2 2 0 0 0 0 0 0 1 1
1 0 0 0 0 0 0 0 0 0 0 9 8 7 6 0 0 0 0 0 0 0 0 0 0 0 0 0 0 1 1
1 0 0 0 0 0 0 0 0 0 10 3 3 3 4 0 0 0 0 0 0 0 0 0 0 0 0 0 0 1 1
1 0 0 0 0 0 0 0 0 0 11 3 3 3 4 0 0 0 0 0 0 0 0 0 0 0 0 0 0 1 1
1 0 0 0 2 2 2 2 2 0 12 5 5 5 0 0 2 2 2 2 2 0 0 0 0 0 0 0 0 1 1
1 0 0 0 2 0 0 0 2 0 13 14 15 0 0 0 2 0 0 0 2 0 0 0 0 0 0 0 0 1 1
1 0 0 0 2 0 0 0 2 0 0 0 0 0 0 0 2 0 0 0 0 0 0 0 0 0 0 0 0 1 1
1 0 0 0 2 2 2 2 2 0 0 0 0 0 0 0 2 2 2 2 2 0 0 0 0 0 0 0 0 1 1
1 0 0 0 0 0 0 0 0 0 0 0 0 0 0 0 0 0 0 0 0 0 0 0 0 0 0 0 0 1 1
1 0 0 0 0 0 0 0 0 0 0 0 0 0 0 0 0 0 0 0 0 0 0 0 0 0 0 0 0 1 1
1 0 0 0 0 0 0 0 0 0 0 0 0 0 0 0 0 0 0 0 0 0 0 0 0 0 0 0 0 1 1
1 0 0 0 0 0 0 0 0 0 0 0 0 0 0 0 0 0 0 0 0 0 0 0 0 0 0 0 0 0 1 
1 1 1 1 1 1 1 1 1 1 1 1 1 1 1 1 1 1 1 1 1 1 1 1 1 1 1 1 1 0
1 1 1 1 1 1 1 1 1 1 1 1 1 1 1 1 1 1 1 1 1 1 1 1 1 1 1 1 1 1